NO ./textures/test.xpm
SO ./textures/kzmin.xpm
EA ./textures/kzmin.xpm
WE ./textures/kzmin.xpm


C 0,200,255
              F 	19,180,100

        1111111111111111111111111
        1000000000110000000000001
        1011000001110000000000001
        1001000000000000000000001
111111111011000001110000000000001
100000000000000000000000000000001
100000000011000001110111111111111
11110111111111101100000010001
100000000000000000000000000001
11110111111111001101010010001
100000000000000000000000000001
10000000000000000W0000000000001
100000000000000000000000000001
10000000000000001100000010001
100000000000000000000000000001
100000000000000000000000000001
11000000110101011100000010001
10000000000000001101010010001
11000011101010111110111100111
1110111 1110101 10111101001
11111111 1111111 111111111111



