NO ./textures/3.xpm
SO ./textures/7.xpm
WE ./textures/4.xpm
EA ./textures/5.xpm

F 120,22,12
C 138,92,135

 11111111111111111111111111111111111111111111111111
 10000000000000000000000000000000000000000000000001
 10000000000000000000000000000000000000000000000001
 10000000000000000000000000000000000000000000000001
 10000000000000000000000000000000000000000000000001
 10000000000000000000000000000000000000000000000001
 10000000000000000000000000000000000000000000000001
 10000000000000000000000000000000000000000000000001
 10000000000000000000000N00000000000000000000000001
 10000000000000000000000000000000000000000000000001
 10000000000000000000000000000000000000000000000001
 10000000000000000000000000000000000000000000000001
 10000000000000000000000000000000000000000000000001
 10000000000000000000000000000000000000000000000001
 10000000000000000000000000000000000000000000000001
 10000000000000000000000000000000000000000000000001
 11111111111111111111111111111111111111111111111111